--------------------------#
--------------------------#
--------------------------#
--------------------------#
--------------------------#
--------------------------#
--------------------------#
--------------------------#
--------------------------#
--------------------------#
--------------------------#
--------------------------#
--------------------------#
--------------------------#
--------------------------#
X-------------------------#
--------------------------#
--------------------------#
---------B----------------#
0000000####0000000000000000